

-------------
---       ---
-----   -----
---       ---
-------------
